{
  "AB": "",
  "AC": "",
  "AG": "guitar-acoustic-steel",
  "AL": "",
  "AP": "",
  "AS": "saxophone-alto",
  "AT": "",
  "BA": "",
  "BD": "",
  "BE": "",
  "BG": "",
  "BJ": "",
  "BL": "",
  "BS": "",
  "BT": "",
  "BY": "",
  "CA": "",
  "CB": "bass-double",
  "CG": "guitar-acoustic-nylon",
  "CH": "",
  "CL": "clarinet",
  "CN": "",
  "CO": "",
  "CR": "",
  "CS": "",
  "CU": "",
  "CV": "",
  "CW": "",
  "DA": "",
  "DO": "",
  "EB": "",
  "EG": "",
  "EH": "horn-english",
  "EP": "",
  "FG": "bassoon",
  "FL": "flute",
  "FT": "",
  "G1": "",
  "G2": "",
  "G3": "",
  "GL": "",
  "GO": "",
  "HA": "",
  "HC": "",
  "HD": "",
  "HH": "",
  "HM": "",
  "HO": "",
  "HP": "",
  "HR": "horn-french",
  "HT": "",
  "JB": "",
  "KM": "",
  "KT": "",
  "KZ": "",
  "LT": "",
  "MB": "",
  "MC": "",
  "MD": "",
  "ME": "",
  "MT": "",
  "ND": "",
  "OB": "oboe",
  "OD": "",
  "OR": "",
  "PC": "",
  "PF": "piano",
  "PN": "",
  "QJ": "",
  "RC": "",
  "SA": "",
  "SD": "",
  "SH": "",
  "SI": "",
  "SK": "",
  "SO": "",
  "SP": "",
  "SR": "",
  "SS": "saxophone-soprano",
  "ST": "",
  "SW": "",
  "SZ": "",
  "T1": "",
  "T2": "",
  "T3": "",
  "T4": "",
  "TA": "",
  "TB": "trombone",
  "TD": "",
  "TI": "",
  "TK": "",
  "TL": "",
  "TM": "",
  "TN": "",
  "TR": "trumpet",
  "TS": "",
  "TT": "",
  "TU": "tuba",
  "UK": "",
  "VC": "cello",
  "VF": "",
  "VI": "",
  "VL": "viola",
  "VM": "",
  "VN": "violin",
  "VS": "",
  "WB": "",
  "WC": "",
  "WH": "",
  "XY": "",
  "Y1": "",
  "Y2": "",
  "Y3": "",
  "YA": "",
  "YC": "",
  "YF": "",
  "YH": "",
  "YR": "",
  "YS": ""
}
